000000000000000
911110000000000
011111111121111
000010000110000
000010000111100
000010000000000
000011111111180
000000000000000